24
xxxxxxxxxxxxxxxxxxxxxxxxx
x.........x.............x
x.xxx.xxx.x.xxx.xxx.xxx.x
x.x...x.x.x.x.x.x...x.x.x
x.xxx.x.x.x.x.x.xxx.x.x.x
x.......................x
x.x...................x.x
x.x...................x.x
x.xxx.....xxx.......xxx.x
x...x.......x...........x
x...x...x...x...x.......x
x.......x.......x.......x
x.xxx...x.xxxxx.x.x.xxx.x
x.................x...x.x
xxx...............x...x.x
x.......................x
x.xxx.....xxx...........x
x.........x.............x
x.........x...........x.x
x.......................x
x.x.x.xxx.x.x...x.x.xxx.x
x.x.x.x...x.x...x.x.x...x
x.xxx.xxx.x.x.x.xxx.xxx.x
x.............x.........x
xxxxxxxxxxxxxxxxxxxxxxxxx