14
xxxxxxxxxxxxxxx
x.............x
xxx.x.xxx.x.xxx
x.............x
x.xxx.x.x.xxx.x
x.x.x.x.x.x.x.x
x.xxx.x.x.xxx.x
x.............x
x.xxxxx.xxxxx.x
x.....x.x.....x
xxx.x.xxx.x.xxx
x...x.....x...x
x.x.xxxxxxx.x.x
x.x.........x.x
xxxxxxxxxxxxxxx