14
xxxxxxxxxxxxxx
x............x
x.xxxxxxxxxx.x
x.x..........x
x.x....xxxxx.x
x.x........x.x
x.x...xx...x.x
x.x........x.x
x.x.xxxxxx.x.x
x.x........x.x
x.x........x.x
x.x........x.x
x.xxxxx....x.x
x.x...x....x.x
x.xxxxx....x.x
x..........x.x
x.xxxxxxxxxx.x
x............x
xxxxxxxxxxxxxx