14
xxxxxxxxxxxxxxx
x.............x
x.xxx.xxxxxxx.x
x.x.........x.x
x.x.xxx.xxx.x.x
x.......x.....x
x.xxx.xxx...x.x
x.x.........x.x
x.x...xxx.xxx.x
x.............x
x.xxx.x.x.xxx.x
x.x...x.x.....x
x.x.x.x.xxx.x.x
x...x.........x
xxxxxxxxxxxxxxx