15
xxxxxxxxxxxxxxx
x.............x
x.xxxxxxxxxx..x
x.x...........x
x.x.xxx....x..x
x.x.xxx....x..x
x.x.xxx....x..x
x.x........x..x
x.x....xxx.x..x
x.x....xxx.x..x
x......xxx.x..x
x..........x..x
x.xxxxxxxxxx..x
x.............x
xxxxxxxxxxxxxxx